FirstName	MiddleInitial	LastName
Aaron	J	Fisher
Abhishek		Sharma
Adam	 M.	Johansen
Adrián		Arnaiz-Rodríguez
Adrián		Javaloy
Ahmed	M	Hendawy
Akira		Tanimoto
Alex		Ayoub
Alexander		Marx
Alexander		Mey
Alexandre		Forel
Alexandre		Hippert-Ferrer
Alexis		Ayme
Alicia		Curth
Amur		Ghose
An-phi		Nguyen
Andi		Zhang
Andrés 	F	López-Lopera 
Anna		Kukleva
Annabelle		Carrell
Anthony		Sicilia
Anton	R	Lundborg
Aramayis		Dallakyan
Arber		Qoku
Arto		Klami
Ashwini 		Pokle
Austin	J	Tripp
Babak		Esmaeili
Bahareh		Tolooshams
Barry		Haddow
Benjamin		Letham
Benjamin		Quost
Biagio		La Rosa
Chancellor	AJ	Johnstone
Chao		Lan
Charles		Guilles-Escuret
Cheng	 	Li
Chengchun		Shi
Chhavi		Yadav
Ching-pei		Lee
Christian		Shelton
Christopher		Nemeth
Chuanhao		Li
Claudia		Di Caterina
Connor		Lawless
Daniel		Barrejon
David		Alvarez-Melis
David		Ruhe
Davoud		Ataee Tarzanagh
Dharmesh		Tailor
Dingfan		Chen
Dominic		Danks
Eddie		Aamari
Eduardo	F	Montesuma
Edwige		Cyffers
Eliana 	M	Duarte Gelvez
Ellen		Novoseller
Emanuele		Sansone
Emiel		Hoogeboom
Ethan	N	Epperly
Fabrizio		Russo
Fan		Yang
Fan		Zhou
Fariba		Yousefi
Federico		Bergamin
Feiyang		Kang
Florentin		Coeurdoux
Florian		Lalande
Gael	P	Varoquaux
Gaetano		Romano
Gang		Cheng
Gaurav		Sinha
Geoff		Pleiss
Gezheng		Xu
Giannis	 	Nikolentzos
Giovanni		Charles
Giulia		Denevi
Giuseppe		Casalicchio
Graham		Cormode
Gregory		Faletto
Hadrien		Hendrikx
Han 		Shen
Haolin		RUAN
Haotian		Ye
Harri	 	Lähdesmäki
Harry	J	Cunningham
Heiner		Kremer
Hongseok	 	Yang
Hongwei		Jin
Houston		Warren
Hugo		Schmutz
Hugo	HJ	Senetaire
Ignacio		Peis
Imon	I	Banerjee
Iñigo	 	Urteaga
Itay	 	Evron
Jaeho		Lee
James		Foulds
Javier		Burroni
Jawad		Chowdhury
Jayanth	R	Regatti
Jens		Sjölund
Jessica		Sorrell
Jiachen		Yang
Jiacheng		Zhu
Jianfeng		Chi
Jilles		Vreeken
Jim		Boelrijk
Johannes		Textor
Jonas		Rothfuss
Jonathan		Foldager
Jonathan		Niles-Weed
Jonathan	 	Scarlett
Joonas		Jälkö
Jun		Wen
Junhyung Lyle		Kim
Juyeon		Heo
Kai-Zhan		Lee
Kaiyi	 	Ji
Kaizhao		Liang
Keegan		Harris
Kentaro		Kanamori
Kevin	M	Xia
Konstantin		Donhauser
Kristoffer		Stensbo-Smidt
Kuk Jin		Jang
Kumar Kshitij		Patel
Laurens		Sluijterman
Lijie		Hu
Lily		Zhang
Lisha		Chen
Louis		Filstroff
Luhuan		Wu
Luo	 	Luo
Maksym		Neyra-Nesterenko
Marco		Mondelli
Marco		Rando
Margaux		Zaffran
Mariana	Yukari	Noguti
Mariya		Mamajiwala
Mark	A	Hallen
Markus	 	Heinonen
Martin		Trat
Mathieu		Even
Matko		Bošnjak
Matt		Shannon
Matteo		Gamba
Matthew	E	Werenski
Maurice	 	Diesendruck
Max		Simchowitz
Michael	C	Hughes
Michaël		Perrot
Miguel		González-Duque
Mikkel	N	Schmidt
Mirco		Musolesi
Myeongjong		Kang
Naman		Awasthi
Neil	B	Band
Nikita		Puchkin
Nina	L	Corvelo Benz
Nuri Mert		Vural
Odalric		Maillard
Olivier		Cappé
Oscar		Li
Oskar		Kviman
Ossi		Räisä
Pan		Kessel
Paolo		Morettin
Parnian		Kassraie
Patrick		Blöbaum
Patrick		Saux
Paul	 	Vicol
Pedro		Cisneros-Velarde
Pengzhou		Wu
Per		Sidén
Petrus		Mikkola
Philipp	 	Berens
Philipp	J	Dahlinger
Pierre		Glaser
Pingchuan		Ma
Prathamesh	 	Patil
Qinyi		Zhang
Quoc Phong		Nguyen
Rachael Hwee Ling		Sim
Rajarshi		Saha
Rémy		Degenne
Richard		Michael
Rif	 	A. Saurous
Roshan		Shariff
Russell		Tsuchida
Ryan		Carey
Saba		Ahmadi
Saeed		Sharifi-Malvajerdi
Sahra		Ghalebikesabi
Salvatore		Ruggieri
Sarah		Jabbour
Sebastian	E	Ament
Seiya		Tokui
Shashank	 	Singh
Shimeng		Huang
Shubhanshu		Shekhar
Simon		Buchholz
Sorawit		Saengkyongam
Souradip		Chakraborty
ST	 	John
Stefan	C	Schonsheck
Stefanos		Eleftheriadis
Steffen		Ridderbusch
Stratis		Markou
Tan		Zhi-Xuan
Tavor	Z	Baharav
Thai-Hoang		Pham
Thomas		Augustin
Thomas		Courtade
Thomas		Moellenhoff
Tiago		Salvador
Tianjiao		Chu
Tianle		Zhang
Tianlei		Jin
Tim		Reichelt
Timothy		Marrinan
Tobias		Leemann
Tobias		Scheffer
Tom		Diethe
Tomi	 	Silander
Toni		Karvonen
Toshiyuki		Tanaka
Vaishnavh		Nagarajan
Valentin		Breaz
Valentina		Zantedeschi
Valentyn		Melnychuk
varun		gupta
Vladimir		Mikulik
Weihao		Gao
Wentao		Yu
Wesley		Maddox
Wu		Lin
Xenia		Miscouridou
Xi		Zhang
Xiaojie		Mao
Xiaoqing		Tan
Xinyi		Xu
Xueying		Bai
Yao		Zhang
Yi		Ren
Yizhou		Chen
Yohan		Jung
Yoichi	 	Chikahara
Yuanzhou		Chen
Yue		Sun
Zheng		Zhao
Zhengyu		Chen
Zhengyu		Zhao
Ziyu		Wang